O3   x:9   y: 1
O3   x:8   y: 0
........O...A
....G........
....H.......N
..A...A.O....
...N...A...G.
......D.O..Z.
.............
..HZ........A
..D.....A....
..U..A.......
.....A.....N.
.D......C....
....L........



O4   x:8   y: 3
O4   x:8   y: 3
........O...A
....G........
....H.......N
..A...A.O....
...N.......G.
......DAO..Z.
.............
..HZ........A
..D.....A....
..U..A.......
.....A.....N.
.D......C....
....L........



O5   x:8   y: 5
O5   x:9   y: 4
........O...A
....G........
....H.......N
..A...A.O....
...N.....O.G.
......DA...Z.
.............
..HZ........A
..D.....A....
..U..A.......
.....A.....N.
.D......C....
....L........



A6   x:8   y: 8
A6   x:9   y: 9
........O...A
....G........
....H.......N
..A...A.O....
...N.....O.G.
......DA...Z.
.............
..HZ........A
..D..........
..U..A...A...
.....A.....N.
.D......C....
....L........



A7   x:6   y: 3
A7   x:6   y: 4
........O...A
....G........
....H.......N
..A.....O....
...N..A..O.G.
......DA...Z.
.............
..HZ........A
..D..........
..U..A...A...
.....A.....N.
.D......C....
....L........



A8   x:2   y: 3
A8   x:3   y: 3
........O...A
....G........
....H.......N
...A....O....
...N..A..O.G.
......DA...Z.
.............
..HZ........A
..D..........
..U..A...A...
.....A.....N.
.D......C....
....L........



A9   x:12   y: 0
A9   x:12   y: 0
........O...A
....G........
....H.......N
...A....O....
...N..A..O.G.
......DA...Z.
.............
..HZ........A
..D..........
..U..A...A...
.....A.....N.
.D......C....
....L........



A10   x:7   y: 5
A10   x:6   y: 7
........O...A
....G........
....H.......N
...A....O....
...N..A..O.G.
......D....Z.
.............
..HZ..A.....A
..D..........
..U..A...A...
.....A.....N.
.D......C....
....L........



A11   x:12   y: 7
A11   x:12   y: 7
........O...A
....G........
....H.......N
...A....O....
...N..A..O.G.
......D....Z.
.............
..HZ..A.....A
..D..........
..U..A...A...
.....A.....N.
.D......C....
....L........



A12   x:5   y: 9
A12   x:6   y: 10
........O...A
....G........
....H.......N
...A....O....
...N..A..O.G.
......D....Z.
.............
..HZ..A.....A
..D..........
..U......A...
.....AA....N.
.D......C....
....L........



A13   x:5   y: 10
A13   x:5   y: 10
........O...A
....G........
....H.......N
...A....O....
...N..A..O.G.
......D....Z.
.............
..HZ..A.....A
..D..........
..U......A...
.....AA....N.
.D......C....
....L........



L14   x:4   y: 12
L14   x:3   y: 12
........O...A
....G........
....H.......N
...A....O....
...N..A..O.G.
......D....Z.
.............
..HZ..A.....A
..D..........
..U......A...
.....AA....N.
.D......C....
...L.........



Z15   x:11   y: 5
Z15   x:11   y: 5
........O...A
....G........
....H.......N
...A....O....
...N..A..O.G.
......D....Z.
.............
..HZ..A.....A
..D..........
..U......A...
.....AA....N.
.D......C....
...L.........



Z16   x:3   y: 7
Z16   x:3   y: 7
........O...A
....G........
....H.......N
...A....O....
...N..A..O.G.
......D....Z.
.............
..HZ..A.....A
..D..........
..U......A...
.....AA....N.
.D......C....
...L.........



